11111111111111111111111111
11111111E111110C0100000111
11111111010001010101110111
11111111010000000000100011
1111111100010101010110C011
1111111111110C010C01100011
11111111111111111111110111
11100000000111100000000111
11101111100000101111110111
11101111100000001111010101
111C1111111111101111110111
11101000000010000111110111
11000000000000000C00110111
11011111111111111111110111
11000111111110000000000111
11101111111010C0C0C0C01011
111P1111111010000000001011
11111111111111111111111111


